R 1280 720
NO ./images/wall0.xpm
SO ./images/wall1.xpm
WE ./images/wall2.xpm
EA ./images/wall3.xpm

S ./images/sprite.xpm
F 59,148,142
C 77,143,172

        1111111111111111111111111
        1000000000110000000000001
        1011000001110000022200001
        1001000000000000000000001
111111111011000001110000000000001
100000000011000001110111112111111
11110111111111011100000010021
11110111111111011101010010021
11000000110101011100001010221
10000000000000001100010000021
10000000000000001101010010001
11000001110101011111011110N11
11110111 1110101 101111010001
11111111 1111111 111111111111